110111011100100
010101010100100
010101010100100
010101010100100
010101010100100
111101110111110
000000000000000