1101110111001
0101010101001
0101010101001
0101010101001
0101010101001
0111011101111