11011101110010
01010101010010
01010101010010
01010101010010
01010101010010
11110111011111
00000000000000