110111011100001
010101010100001
010101010100001
010101010100001
010101010100001
010101010100001
010101010100001
011101110111111